NO ./NO_TEXT.xpm
SO ./SO_TEXT.xpm
WE ./WE_TEXT.xpm
EA ./EA_TEXT.xpm



F 225,30,10
C 225,30,10



1111111111111111111111111
1000000000110000000000001
1000000000110000000000001
1011000001110000000000001
1011000001110000000000001
1000000000000000000000001
1001000000000000000000001
1111000000010101010100001
1111000000001000000000001
1000000000110N00011101111
1000000000110000011101111
1011000001110000000000001
1011000001110000000000001
1011000001110000000000001
1011000001110000000000001
1111000111111000010000001
1111000111111000010000001
1111000111111000000000001
1111000111111000000000001
1100000011010000010000001
1100000011010000010000001
1000000000000000110000001
1000000000000000110000001
1000000000000000110000001
1111111111111111111111111