111111111111111111111111111
100000001111100000000000011
10000000111110000000011111
1000000011111000000011
10000000111110000000001111
1000000011111000000011000011
100000001111100000010000011
111111111111111111111111111
